NO ./textures/cobblestone.XPM
SO ./textures/deepslate.XPM
WE ./textures/diamond_ore.XPM
EA ./textures/spruce_log.XPM

C 144, 218, 252
F 77, 63, 48

11111111111
10000000001
10000000001
10001110001
10000000001
11000000001
10000N00001
10000000001
10000000111
10001000001
11111111111
